mystery.ogg 12 12 11 11 1 map01 map05
0 0 0 0 1 1 1 1 1 1 1 1 1 1 1 1 1 1 1 1 1 1 1 1 1
1 1 1 1 1 1 1 1 1 1 1 1 1 1 1 1 1 1 1 1 1 1 1 1 1
1 1 1 1 1 1 1 1 1 1 1 1 1 1 1 1 1 1 1 1 1 1 1 1 1
1 1 1 1 1 1 1 1 1 1 1 1 1 1 1 1 1 1 1 1 1 1 1 1 1
1 1 1 1 1 1 1 1 1 1 1 1 1 1 1 1 1 1 1 1 1 1 1 1 1
1 1 1 1 1 1 1 1 1 1 1 46 1 1 1 1 1 1 1 1 1 1 1 1 1
1 1 1 1 1 1 1 1 1 1 1 46 1 1 1 1 1 1 1 1 1 1 1 1 1
1 1 1 1 1 1 1 1 1 1 1 46 1 1 1 1 1 1 1 1 1 1 1 1 1
1 1 46 46 46 46 46 46 46 46 46 46 1 1 1 1 1 1 1 1 1 1 1 1 1
1 1 1 1 1 1 1 1 1 1 1 1 1 1 1 1 1 1 1 1 1 1 1 1 1
1 1 1 1 1 1 1 1 1 1 1 1 1 1 1 1 1 1 1 1 1 1 1 1 1
1 1 1 1 1 1 1 1 1 1 1 1 1 1 33 1 1 1 1 1 1 1 1 1 1
1 1 1 1 1 1 1 1 1 1 1 1 1 35 38 34 1 1 1 1 1 1 1 1 1
1 1 1 1 1 1 1 1 1 1 1 1 35 39 38 39 34 1 1 1 1 1 1 1 1
1 1 1 1 1 1 1 1 1 1 1 35 37 37 36 37 37 34 1 1 1 1 1 1 1
1 1 1 1 1 1 1 1 1 1 35 39 39 39 38 39 39 39 34 1 1 1 1 1 1
-1 131 132 133 -1 -1 45 50 50 50 50 50 50 50 50 50 50 48 -1 -1 -1 -1 -1 -1 -1
-1 163 164 165 -1 -1 49 20 20 -1 64 65 66 -1 -1 -1 -1 49 -1 -1 -1 -1 -1 -1 -1
-1 195 196 197 -1 -1 49 -1 -1 -1 96 97 98 -1 -1 -1 -1 49 -1 -1 -1 -1 -1 -1 -1
-1 -1 -1 -1 20 -1 49 -1 -1 -1 -1 -1 -1 -1 -1 -1 -1 49 -1 -1 -1 -1 20 -1 -1
-1 -1 -1 -1 -1 -1 46 50 50 50 50 274 50 50 50 50 50 47 -1 -1 -1 -1 -1 -1 -1
-1 -1 -1 -1 -1 -1 -1 -1 -1 -1 24 -1 25 -1 -1 -1 -1 -1 -1 -1 -1 -1 -1 -1 -1
-1 -1 216 217 218 219 216 217 216 217 24 -1 25 -1 -1 -1 -1 -1 -1 -1 -1 -1 -1 -1 -1
-1 -1 23 23 23 23 23 23 23 28 24 -1 25 -1 216 217 218 219 216 217 218 219 216 217 216
-1 -1 -1 -1 -1 -1 -1 -1 -1 -1 -1 -1 25 -1 -1 -1 -1 -1 -1 -1 -1 -1 -1 -1 -1
-1 -1 23 23 23 23 23 23 23 23 23 23 28 -1 -1 -1 -1 -1 -1 -1 -1 -1 -1 -1 -1
-1 -1 216 217 218 219 216 217 218 219 216 217 216 217 218 219 216 217 218 219 216 217 218 219 216
-1 -1 -1 -1 -1 -1 -1 -1 -1 -1 -1 -1 -1 -1 -1 -1 -1 -1 -1 -1 -1 -1 -1 -1 -1
-1 -1 -1 -1 -1 -1 -1 -1 -1 -1 -1 -1 -1 -1 -1 -1 -1 -1 -1 -1 -1 -1 -1 -1 -1
-1 -1 -1 -1 -1 20 -1 -1 -1 -1 -1 -1 -1 -1 -1 -1 -1 20 -1 -1 -1 -1 -1 -1 -1
-1 -1 -1 -1 -1 -1 -1 -1 -1 -1 -1 -1 -1 -1 -1 -1 -1 -1 -1 -1 -1 -1 -1 -1 -1
-1 -1 -1 -1 -1 -1 -1 -1 -1 -1 -1 -1 -1 -1 -1 -1 -1 -1 -1 -1 -1 -1 -1 -1 -1
-1 -1 -1 -1 -1 -1 -1 -1 -1 -1 -1 -1 -1 -1 -1 -1 -1 -1 -1 -1 -1 -1 -1 -1 -1
-1 -1 -1 -1 -1 -1 -1 10 -1 -1 -1 -1 -1 -1 -1 -1 12 -1 -1 -1 -1 -1 -1 -1 -1
-1 -1 -1 -1 -1 -1 -1 -1 -1 -1 -1 -1 -1 -1 -1 -1 -1 -1 -1 -1 -1 -1 -1 -1 -1
-1 -1 -1 -1 -1 -1 -1 11 -1 -1 7 8 9 -1 12 10 10 -1 -1 -1 -1 -1 -1 -1 -1
-1 -1 22 23 22 23 22 23 22 23 -1 -1 -1 -1 -1 -1 -1 -1 -1 -1 -1 -1 -1 -1 -1
-1 -1 36 37 36 37 36 37 36 37 -1 -1 -1 -1 22 23 22 23 22 23 22 23 22 23 22
-1 -1 -1 -1 -1 -1 -1 -1 -1 -1 -1 -1 -1 -1 36 37 36 37 36 37 36 37 36 37 36
-1 -1 -1 -1 -1 -1 -1 -1 -1 -1 -1 -1 -1 -1 -1 -1 -1 -1 -1 -1 -1 -1 -1 -1 -1
-1 -1 22 23 22 23 22 23 22 23 22 23 22 23 22 23 22 23 22 23 22 23 22 23 22
-1 -1 36 37 36 37 36 37 36 37 36 37 36 37 36 37 36 37 36 37 36 37 36 37 36
-1 -1 -1 -1 -1 -1 -1 -1 -1 -1 -1 -1 -1 -1 -1 -1 -1 -1 -1 -1 -1 -1 -1 -1 -1
-1 -1 -1 -1 -1 -1 -1 -1 -1 -1 -1 -1 -1 -1 -1 -1 -1 -1 -1 -1 -1 -1 -1 -1 -1
-1 -1 -1 -1 -1 -1 -1 -1 -1 -1 -1 -1 -1 -1 -1 -1 -1 -1 -1 -1 -1 -1 -1 -1 -1
-1 -1 -1 -1 -1 -1 -1 -1 -1 -1 -1 -1 -1 -1 -1 -1 -1 -1 -1 -1 -1 -1 -1 -1 -1
-1 -1 -1 -1 -1 -1 -1 -1 -1 -1 -1 -1 -1 -1 -1 -1 -1 -1 -1 -1 -1 -1 -1 -1 -1
-1 -1 -1 -1 -1 -1 -1 -1 -1 -1 -1 -1 -1 -1 -1 -1 -1 -1 -1 -1 -1 -1 -1 -1 -1